NO texture/eagle.xpm
SO texture/greystone.xpm
EA texture/red.xpm
WE texture/purplestone.xpm

F 0,0,0
C 220,30,0

      1111111111111
     10000000000E001   11111111
     111111111000011111100000001
       100000000000000000000001
        1110000000100000001111
       11000000001 10000000001
    1110000000001   100000001
   1000001111001   1000011111
  100011111111001  100011
 10000000000000001100000011
100000110000111000000000001
 1100100011111111110011111
  1100000000000000000001
    1100111111111111111
     1001
      11
