NO ./nothing
SD ./
WE ./
EA ./

F 220, 100, 0
c 225, 30, 0

               11111111111111111111111111
			   11111111111110111111111111
		1111111100000000000000000000111111
		111000111111111111111111100000001111
	1  1  1 00000000000000000000000000000011
	