NO ./assets/texture/texture.xpm
SD ./assets/texture/texture.xpm
WE ./assets/texture/texture.xpm
EA /assets/texture/texture.xpm

F 220,100,0
C 225,30,0

                1111111111111
               100000000000001   11111111
               111111111000011111100000001
                 100000000000110000000001
                 11111100000000000001111
                1110000000000110000000001
             1111000000000001  100000001
            11000001111001  11000011111
           11000111111110001110001
           1000000000000000000000011
          100000110000111111100000001
           1100100011111111110011111
            1100000000000000000001
            111100111111111111111
               1001
                11